TEAM_ID,TEAM_NAME,TEAM_ABBREVIATION,GP,G,FGA_FREQUENCY,FGM,FGA,FG_PCT,EFG_PCT,FG2A_FREQUENCY,FG2M,FG2A,FG2_PCT,FG3A_FREQUENCY,FG3M,FG3A,FG3_PCT
1610612745,Houston Rockets,HOU,82,82,1,3484,7659,0.455,0.523,0.616,2446,4721,0.518,0.384,1038,2938,0.353
1610612760,Oklahoma City Thunder,OKC,82,82,1,3660,7600,0.482,0.56,0.581,2468,4416,0.559,0.419,1192,3184,0.374
1610612763,Memphis Grizzlies,MEM,81,82,1,3625,7559,0.48,0.555,0.593,2489,4485,0.555,0.407,1136,3074,0.37
1610612741,Chicago Bulls,CHI,82,82,1,3538,7538,0.469,0.553,0.543,2273,4094,0.555,0.457,1265,3444,0.367
1610612737,Atlanta Hawks,ATL,82,82,1,3553,7521,0.472,0.546,0.59,2447,4435,0.552,0.41,1106,3086,0.358
1610612761,Toronto Raptors,TOR,82,82,1,3411,7457,0.457,0.522,0.627,2442,4672,0.523,0.373,969,2785,0.348
1610612739,Cleveland Cavaliers,CLE,82,82,1,3652,7444,0.491,0.578,0.543,2349,4043,0.581,0.457,1303,3401,0.383
1610612744,Golden State Warriors,GSW,82,82,1,3338,7403,0.451,0.536,0.531,2074,3931,0.528,0.469,1264,3472,0.364
1610612757,Portland Trail Blazers,POR,82,82,1,3325,7396,0.45,0.521,0.582,2268,4301,0.527,0.418,1057,3095,0.342
1610612758,Sacramento Kings,SAC,82,82,1,3529,7385,0.478,0.548,0.609,2497,4497,0.555,0.391,1032,2888,0.357
1610612764,Washington Wizards,WAS,82,82,1,3233,7370,0.439,0.512,0.564,2158,4160,0.519,0.436,1075,3210,0.335
1610612740,New Orleans Pelicans,NOP,82,82,1,3331,7365,0.452,0.519,0.615,2345,4526,0.518,0.385,986,2839,0.347
1610612759,San Antonio Spurs,SAS,82,82,1,3426,7362,0.465,0.544,0.559,2268,4115,0.551,0.441,1158,3247,0.357
1610612765,Detroit Pistons,DET,82,82,1,3500,7357,0.476,0.547,0.606,2451,4460,0.55,0.394,1049,2897,0.362
1610612754,Indiana Pacers,IND,82,82,1,3574,7326,0.488,0.562,0.6,2493,4392,0.568,0.4,1081,2934,0.368
1610612766,Charlotte Hornets,CHA,82,82,1,3142,7308,0.43,0.503,0.57,2077,4165,0.499,0.43,1065,3143,0.339
1610612738,Boston Celtics,BOS,82,82,1,3371,7296,0.462,0.561,0.463,1925,3375,0.57,0.537,1446,3921,0.369
1610612743,Denver Nuggets,DEN,82,82,1,3686,7277,0.507,0.573,0.645,2716,4693,0.579,0.355,970,2584,0.375
1610612762,Utah Jazz,UTA,82,82,1,3305,7271,0.455,0.533,0.551,2161,4005,0.54,0.449,1144,3266,0.35
1610612752,New York Knicks,NYK,81,82,1,3507,7217,0.486,0.556,0.618,2490,4462,0.558,0.382,1017,2755,0.369
1610612742,Dallas Mavericks,DAL,82,82,1,3443,7193,0.479,0.55,0.611,2423,4392,0.552,0.389,1020,2801,0.364
1610612750,Minnesota Timberwolves,MIN,82,82,1,3364,7183,0.468,0.554,0.545,2131,3914,0.544,0.455,1233,3269,0.377
1610612755,Philadelphia 76ers,PHI,82,82,1,3253,7167,0.454,0.526,0.575,2213,4118,0.537,0.425,1040,3049,0.341
1610612748,Miami Heat,MIA,82,82,1,3318,7138,0.465,0.544,0.571,2194,4078,0.538,0.429,1124,3060,0.367
1610612749,Milwaukee Bucks,MIL,82,82,1,3445,7082,0.486,0.568,0.576,2284,4079,0.56,0.424,1161,3003,0.387
1610612756,Phoenix Suns,PHX,82,82,1,3380,7074,0.478,0.561,0.56,2205,3963,0.556,0.44,1175,3111,0.378
1610612746,LA Clippers,LAC,82,82,1,3409,7073,0.482,0.554,0.613,2387,4335,0.551,0.387,1022,2738,0.373
1610612751,Brooklyn Nets,BKN,82,82,1,3086,7060,0.437,0.516,0.542,1973,3828,0.515,0.458,1113,3232,0.344
1610612753,Orlando Magic,ORL,82,82,1,3130,7035,0.445,0.51,0.589,2209,4143,0.533,0.411,921,2892,0.318
1610612747,Los Angeles Lakers,LAL,82,82,1,3356,7004,0.479,0.557,0.574,2264,4023,0.563,0.426,1092,2981,0.366
